10 10
1 1 1 1 1 1 1 1 1 1
1 0 0 0 0 0 0 0 0 1
1 0 0 0 0 0 0 0 0 1
1 0 0 0 0 0 0 0 0 1
1 0 0 0 0 0 0 0 0 1
1 0 0 0 0 0 0 0 0 1
1 0 0 0 0 0 0 0 0 1
1 2 0 0 0 0 0 0 0 1
1 0 0 0 0 5 0 0 8 1
1 1 1 1 1 1 1 1 1 1

5,8
Dagger 1
-
-