10 20
1 1 1 1 1 1 1 1 1 1
1 0 0 0 0 0 0 0 0 1
1 0 0 0 0 0 0 0 0 1
1 0 0 0 0 0 0 0 0 1
1 0 0 0 0 0 0 0 0 1
1 0 0 0 0 0 0 0 0 1
1 0 0 0 0 0 0 0 0 1
1 0 0 2 0 0 0 0 0 1
1 1 1 1 1 1 1 0 0 1
1 0 0 0 0 0 0 0 0 1
1 0 0 0 0 0 0 0 0 1
1 0 0 0 0 0 0 0 0 1
1 0 0 0 0 0 0 0 0 1
1 0 0 0 0 0 0 0 0 1
1 6 1 1 1 1 1 0 0 1
1 4 0 0 0 0 0 0 0 1
1 4 0 0 0 0 0 0 0 1
1 4 0 0 0 0 0 0 0 1
1 4 0 0 0 0 7 0 0 1
1 1 1 1 1 1 1 1 1 1

-
6,18
6 13
5 18
-1 -1
-