20 10
1 1 1 1 1 1 1 1 1 1 1 1 1 1 1 1 1 1 1 1
1 0 0 0 0 0 0 0 0 0 0 0 0 0 0 0 0 0 0 1
1 0 0 0 0 0 0 0 0 0 0 0 0 0 0 0 0 0 0 1
1 0 2 0 0 0 0 0 0 0 0 0 0 0 0 0 0 0 0 1
1 1 1 1 1 1 1 1 1 1 1 1 1 6 0 0 0 0 0 1
1 0 0 0 0 0 0 0 0 0 0 0 0 4 0 0 0 0 0 1
1 0 0 0 0 0 0 0 0 0 0 0 0 4 0 0 0 0 0 1
1 0 0 0 0 0 0 0 0 0 0 0 0 4 0 0 0 0 0 1
1 8 0 0 0 0 3 0 0 0 0 0 0 4 0 0 0 0 0 1
1 1 1 1 1 1 1 1 1 1 1 1 1 1 1 1 1 1 1 1

-
6,8
8 8
1 8
11 3
-1 -1
-