20 5
1 1 1 1 1 1 1 1 1 1 1 1 1 1 1 1 1 1 1 1
1 0 0 0 0 0 0 0 0 0 0 0 0 0 0 0 0 0 0 1
1 0 0 0 0 0 0 0 0 0 0 0 0 0 0 0 0 7 0 1
1 0 2 0 0 0 0 0 0 0 0 0 9 9 9 9 9 9 9 1
1 1 1 1 1 1 1 1 1 1 1 1 1 1 1 1 1 1 1 1

-
17,2
15 3
13 2
17 2
-1 -1
-